#########################
#.......................#
#.......................#
#.......................#
#.....####..............#
#.....#>*#..............#
#.....#**#..............#
#......#................#
#.......................#
#.......................#
#......*................#
#.......................#
#...*.......*...........#
#.......................#
#.......................#
#...*...................#
#.......................#
#.......................#
#.......................#
#.......................#
#.......................#
#.......................#
#.......................#
#............@..........#
#.......................#
#########################