#########################
#.......................#
#.......................#
#.....####..............#
#.....#..#..............#
#.....#>*#..............#
#.....#**#..............#
#......#OO..............#
#.......................#
#................OO.....#
#.......................#
#......................O#
#...*.......*...........#
#.......................#
#.......................#
#...*...................#
#.......................#
#.......................#
#.......................#
#............*..........#
#.......................#
#.......O...............#
#.......................#
#............@..........#
#.......................#
#########################