#########################
#.......................#
#.......................#
#.......................#
#.......................#
#.......................#
#.......................#
#.......................#
#.......................#
#.......................#
#.......................#
#.......................#
#.......................#
#...........@<..........#
#.......................#
#.......................#
#.......................#
#.......................#
#.......................#
#.#.....................#
#.#.....................#
#.#.....................#
#.#.....................#
#.#.....................#
#>#.....................#
#########################
