#########################
#.......................#
#.......................#
#.......................#
#.....####..............#
#.....#..#..............#
#.....#..#..............#
#......#................#
#..........@............#
#.......................#
#.......................#
#.......................#
#.......................#
#.......................#
#.......................#
#.......................#
#.......................#
#.......................#
#.......................#
#.......................#
#.......................#
#.......................#
#.......................#
#.......................#
#.......................#
#########################